11111111
1PEC1111
11111111
11111111
